Sr. No. of Polling Station,Patel Himmatsingh Prahladsingh,Paresh Rawal,Rohit Rajubhai Virjibhai Alias Manojbhai Sontariya,Aditya Raval,Khalifa Samsuddin Nasiruddin(Jugnu),Dutt Aakash - Advocate,Dinesh Vaghela,Naranbhai T. Sengal (Dr. N.T.Sengal),Buddhpriya Jasvant Somabhai,Vijaykumar M. Vadhel,Atikbhai Mev,Anilkumar Sharma,Dashrathbhai M. Devda,Roshan Priyavadan Shah,Total No. of Valid Votes,No. of Rejected Votes',NOTA,Total,No. of Tendered Votes
1,245,192,35,1,1,0,4,0,0,1,1,0,3,0,483,0,10,493,0
2,579,287,12,1,0,0,9,0,4,0,1,1,0,0,894,0,15,909,0
3,468,40,2,2,1,0,5,0,1,1,0,0,0,0,520,0,5,525,0
4,104,625,1,1,0,0,9,0,0,0,0,1,0,0,741,0,4,745,0
5,445,51,33,0,1,0,1,0,0,0,0,0,1,6,538,0,18,556,0
6,223,239,4,0,0,0,1,0,1,0,0,0,0,3,471,0,10,481,0
7,209,228,5,0,1,0,4,0,1,1,0,1,1,1,452,0,6,458,0
8,30,547,0,1,0,0,6,0,0,0,0,0,0,0,584,0,7,591,0
9,25,535,1,0,0,0,3,0,1,0,0,0,0,2,567,0,7,574,0
10,155,590,1,0,0,1,14,0,0,0,2,0,1,2,766,0,10,776,0
11,582,188,10,0,1,1,27,0,4,0,0,0,0,1,814,0,14,828,0
12,195,516,3,0,1,0,8,0,0,1,3,1,1,1,730,0,16,746,0
13,242,256,5,0,0,0,6,0,0,0,0,0,3,4,516,0,14,530,0
14,288,103,0,2,0,0,11,0,0,0,0,0,0,0,404,0,8,412,0
15,158,525,11,0,1,1,1,1,0,1,0,1,3,8,711,0,9,720,0
16,345,109,6,1,1,0,7,0,1,0,1,1,0,1,473,0,6,479,0
17,365,84,0,0,0,0,3,0,0,0,0,1,1,0,454,0,4,458,0
18,289,131,2,1,3,0,4,1,0,1,0,0,0,0,432,0,5,437,0
19,294,90,0,0,1,0,3,0,0,0,0,0,1,0,389,0,11,400,0
20,343,120,2,2,0,1,2,0,0,0,0,0,0,1,471,0,3,474,0
21,163,275,2,0,1,0,1,0,0,0,1,0,0,3,446,0,4,450,0
22,168,233,2,0,2,0,7,0,0,0,0,1,0,0,413,0,6,419,0
23,149,741,1,0,1,0,9,0,0,0,0,1,0,0,902,0,12,914,0
24,101,739,3,0,1,0,11,1,0,2,0,0,2,0,860,0,6,866,0
25,164,616,2,2,1,0,5,1,0,0,1,0,2,3,797,0,10,807,0
26,205,88,2,1,0,0,12,0,0,0,0,0,0,0,308,0,9,317,0
27,167,455,3,0,0,2,2,2,0,0,2,3,5,5,646,0,11,657,0
28,222,444,7,1,0,1,11,2,2,1,0,1,1,0,693,0,8,701,0
29,166,323,0,0,0,0,4,0,0,0,0,0,0,0,493,0,5,498,0
30,79,623,1,0,0,0,12,0,1,0,0,1,1,1,719,0,12,731,0
31,372,428,7,1,0,0,19,0,0,1,2,1,3,4,838,0,21,859,0
32,68,453,2,1,0,0,4,1,0,0,0,0,0,0,529,0,7,536,0
33,41,503,1,0,0,0,5,0,0,0,0,1,0,1,552,0,9,561,0
34,49,431,2,0,0,1,11,0,0,0,1,0,1,1,497,0,8,505,0
35,96,341,0,0,0,0,9,0,0,1,0,0,1,2,450,0,7,457,0
36,97,694,3,0,0,1,7,0,1,0,1,0,0,0,804,0,4,808,0
37,87,612,5,0,1,1,7,0,0,0,0,0,2,3,718,0,11,729,0
38,384,426,2,0,1,1,14,0,0,0,2,1,2,1,834,0,10,844,0
39,160,598,11,0,1,0,8,1,1,2,2,0,0,5,789,0,14,803,0
40,187,329,7,0,0,0,1,0,0,1,0,4,3,2,534,0,10,544,0
41,140,674,7,4,1,0,5,1,0,1,2,1,0,4,840,0,13,853,0
42,96,805,0,1,0,0,24,0,0,0,0,2,0,0,928,0,12,940,0
43,310,459,3,0,0,0,4,0,0,0,0,0,3,2,781,0,9,790,0
44,117,489,7,2,2,1,6,1,2,2,1,3,3,9,645,0,13,658,0
45,153,395,2,2,0,0,7,0,1,0,0,0,1,5,566,0,5,571,0
46,284,341,2,2,1,0,1,0,0,0,1,0,0,3,635,0,14,649,0
47,434,370,6,1,0,0,9,0,0,1,1,0,1,2,825,0,7,832,0
48,295,503,6,1,1,1,8,1,2,0,2,1,1,5,827,0,12,839,0
49,232,506,9,1,1,1,8,1,0,2,1,1,5,0,768,0,10,778,0
50,317,435,6,3,1,0,5,0,2,0,0,2,3,14,788,0,7,795,0
51,463,222,1,1,1,0,13,1,0,0,1,0,0,0,703,0,4,707,0
52,87,686,3,2,0,0,8,0,0,1,0,2,1,2,792,0,11,803,0
53,269,400,4,1,0,0,2,1,1,1,2,1,4,5,691,0,13,704,0
54,252,292,2,0,1,1,1,3,0,0,1,0,2,5,560,0,4,564,0
55,147,627,5,1,1,1,8,0,2,1,3,0,7,6,809,0,15,824,0
56,35,442,0,0,0,0,3,0,0,0,0,0,0,1,481,0,6,487,0
57,40,347,3,0,1,0,8,0,0,0,2,1,0,1,403,0,5,408,0
58,368,349,2,0,1,0,6,0,0,0,1,0,1,3,731,0,7,738,0
59,261,449,4,0,2,0,7,2,1,0,2,1,2,5,736,0,11,747,0
60,400,416,11,3,3,0,21,3,2,0,2,1,2,9,873,0,22,895,0
61,299,194,3,0,0,0,17,0,0,0,1,0,1,1,516,0,7,523,0
62,638,8,2,0,2,2,8,1,0,1,0,1,0,0,663,0,1,664,0
63,512,12,0,0,0,0,13,0,0,0,1,0,0,0,538,0,2,540,0
64,316,7,0,0,0,1,6,0,0,0,0,0,0,0,330,0,1,331,0
65,357,152,0,0,0,0,13,1,0,0,0,3,1,1,528,0,7,535,0
66,581,236,10,0,3,0,10,0,0,0,0,0,0,2,842,0,15,857,0
67,94,314,7,0,0,0,7,0,2,0,3,1,1,2,431,0,2,433,0
68,147,271,1,0,0,0,4,0,0,1,0,0,1,2,427,0,4,431,0
69,293,181,5,2,0,0,22,0,0,0,0,1,0,0,504,0,10,514,0
70,272,84,0,0,1,0,12,2,0,0,0,1,0,1,373,0,4,377,0
71,137,369,2,2,0,0,6,1,0,0,5,0,2,4,528,0,9,537,0
72,106,278,8,0,1,0,0,0,1,0,0,0,2,1,397,0,8,405,0
73,497,46,1,0,0,0,7,0,0,0,1,0,1,0,553,0,7,560,0
74,146,414,1,1,1,1,7,1,2,0,0,0,0,2,576,0,6,582,0
75,61,365,7,1,0,0,3,3,0,0,1,0,3,4,448,0,3,451,0
76,79,346,4,1,0,0,2,0,0,0,0,1,1,0,434,0,3,437,0
77,480,51,1,0,0,0,1,0,1,0,1,1,0,3,539,0,8,547,0
78,264,87,1,1,1,0,7,0,0,0,0,0,1,1,363,0,8,371,0
79,413,328,3,0,2,0,8,0,0,0,0,0,1,3,758,0,6,764,0
80,442,65,0,0,0,0,4,0,0,0,0,0,2,0,513,0,1,514,0
81,322,137,2,0,0,0,5,1,1,0,0,0,0,0,468,0,4,472,0
82,599,34,1,0,1,1,11,0,0,0,3,0,3,0,653,0,14,667,0
83,545,98,0,1,1,0,15,0,0,1,1,1,0,4,667,0,10,677,0
84,398,20,0,0,0,0,21,0,0,0,0,0,0,1,440,0,0,440,0
85,430,22,3,0,0,0,6,0,0,0,0,1,0,2,464,0,1,465,0
86,506,18,3,1,2,0,4,0,0,1,0,0,1,0,536,0,0,536,0
87,320,16,0,0,0,1,6,1,0,1,0,1,0,0,346,0,4,350,0
88,247,533,4,0,0,0,12,1,1,1,2,0,6,7,814,0,18,832,0
89,653,22,0,0,1,0,21,1,0,0,0,0,1,0,699,0,1,700,0
90,343,18,0,0,0,0,9,0,0,0,0,0,0,0,370,0,3,373,0
91,480,21,2,2,1,0,9,0,0,0,0,1,0,0,516,0,1,517,0
92,435,28,0,0,1,0,25,0,0,0,0,0,1,0,490,0,4,494,0
93,501,18,1,0,0,0,17,0,0,0,0,1,0,0,538,0,3,541,0
94,351,28,0,0,0,0,19,0,0,0,0,0,0,0,398,0,4,402,0
95,508,35,1,0,0,0,31,1,2,1,1,2,2,2,586,0,9,595,0
96,124,497,2,1,1,2,1,1,0,0,1,0,2,6,638,0,10,648,0
97,75,371,5,0,0,0,5,0,0,0,1,0,0,2,459,0,4,463,0
98,324,339,11,1,0,2,9,2,0,0,0,0,4,2,694,0,12,706,0
99,59,216,2,0,0,0,2,1,1,0,1,1,1,1,285,0,4,289,0
100,346,368,3,0,2,0,5,1,0,1,0,1,1,2,730,0,8,738,0
101,382,399,4,0,0,1,13,2,0,1,2,0,1,1,806,0,11,817,0
102,42,402,4,1,0,0,2,1,0,0,0,0,1,5,458,0,3,461,0
103,86,596,6,2,0,0,3,0,1,2,2,2,6,7,713,0,16,729,0
104,89,134,4,0,0,0,10,0,0,0,0,0,0,0,237,0,2,239,0
105,40,492,1,1,0,2,6,0,1,0,0,1,2,4,550,0,10,560,0
106,28,350,1,1,0,0,0,0,0,2,0,0,0,1,383,0,3,386,0
107,348,480,7,2,1,0,15,2,0,0,0,0,1,1,857,0,16,873,0
108,565,22,0,0,0,0,8,0,0,0,0,0,0,0,595,0,2,597,0
109,271,9,0,0,0,0,3,0,0,0,0,1,0,0,284,0,3,287,0
110,499,16,0,0,0,0,9,0,0,0,2,0,0,0,526,0,2,528,0
111,468,12,0,0,0,0,5,0,0,0,1,0,0,1,487,0,2,489,0
112,452,12,1,0,1,0,10,0,0,0,0,0,0,0,476,0,7,483,0
113,453,12,0,0,0,1,11,1,0,0,0,0,0,1,479,0,5,484,0
114,462,17,1,1,1,1,7,0,0,0,0,0,0,0,490,0,2,492,0
115,583,24,0,0,0,1,11,1,0,0,0,0,0,1,621,0,4,625,0
116,202,386,3,0,1,0,1,0,0,0,0,0,1,1,595,0,11,606,0
117,113,508,1,0,0,0,9,0,0,0,0,1,0,1,633,0,8,641,0
118,172,472,6,0,0,0,13,2,1,0,0,0,0,4,670,0,14,684,0
119,28,171,3,0,0,0,3,0,0,0,0,0,0,1,206,0,0,206,0
120,210,414,4,1,0,1,21,0,0,0,0,0,0,0,651,0,12,663,0
121,104,432,2,0,0,0,22,1,0,0,0,0,0,1,562,0,4,566,0
122,541,269,5,1,2,1,7,0,0,1,0,3,1,1,832,0,20,852,0
123,500,132,1,1,0,4,10,0,0,1,1,1,0,2,653,0,11,664,0
124,313,464,2,1,0,1,20,0,0,0,0,2,6,2,811,0,7,818,0
125,27,358,3,1,0,0,3,0,1,0,0,1,2,1,397,0,9,406,0
126,74,456,2,0,1,0,6,1,0,0,0,1,0,2,543,0,4,547,0
127,47,804,0,0,0,1,12,0,0,1,0,0,2,1,868,0,3,871,0
128,138,60,0,1,0,0,8,0,0,0,1,0,0,0,208,0,3,211,0
129,65,715,7,0,0,0,10,1,0,0,0,1,2,3,804,0,13,817,0
130,64,731,3,0,1,1,7,0,0,0,0,2,0,2,811,0,8,819,0
131,113,598,0,1,1,2,9,2,0,0,0,1,3,0,730,0,8,738,0
132,194,291,1,1,0,0,16,0,0,0,1,2,0,1,507,0,8,515,0
133,213,224,2,1,0,0,12,0,0,1,0,0,0,0,453,0,5,458,0
134,280,501,5,2,1,0,18,0,1,0,0,0,1,1,810,0,4,814,0
135,178,424,1,0,0,0,9,0,0,0,0,0,3,1,616,0,2,618,0
136,170,351,5,0,0,0,15,1,0,0,0,0,0,1,543,0,10,553,0
137,277,495,6,0,0,1,11,1,0,0,1,1,3,0,796,0,8,804,0
138,113,629,4,0,0,0,10,0,0,0,0,0,0,0,756,0,9,765,0
139,214,403,4,0,1,3,15,1,0,0,0,0,1,4,646,0,4,650,0
140,130,521,1,1,0,1,6,0,0,0,1,0,0,0,661,0,13,674,0
141,125,511,3,2,0,1,5,0,0,0,2,1,1,7,658,0,6,664,0
142,59,585,4,0,2,0,12,0,1,0,0,1,1,0,665,0,7,672,0
143,95,573,1,0,0,0,10,0,0,0,1,0,1,2,683,0,6,689,0
144,57,357,4,0,0,0,3,0,0,0,0,0,0,0,421,0,1,422,0
145,53,514,2,3,0,0,11,4,1,1,1,2,1,2,595,0,5,600,0
146,228,175,2,1,0,0,13,1,1,1,0,1,0,0,423,0,13,436,0
147,201,641,3,1,1,2,8,2,1,0,2,1,0,1,864,0,8,872,0
148,157,370,3,0,1,3,21,0,0,0,0,1,1,1,558,0,13,571,0
149,130,284,3,0,0,0,5,1,0,0,0,1,2,0,426,0,9,435,0
150,116,551,11,0,0,0,9,0,0,0,0,0,0,1,688,0,11,699,0
151,356,284,3,0,0,0,21,0,1,0,0,0,0,1,666,0,12,678,0
152,240,74,0,1,0,0,15,1,0,0,0,0,1,0,332,0,6,338,0
153,586,215,4,0,0,0,20,0,0,0,0,2,1,1,829,0,17,846,0
154,378,296,6,0,1,0,17,1,0,0,0,0,2,1,702,0,5,707,0
155,392,308,9,1,0,0,9,0,0,0,1,0,0,0,720,0,12,732,0
156,148,360,1,0,0,1,12,0,0,0,0,0,0,0,522,0,10,532,0
157,108,575,5,1,3,0,8,0,0,1,0,0,1,2,704,0,7,711,0
158,126,734,3,0,0,1,7,0,0,0,0,1,0,2,874,0,5,879,0
159,362,458,3,0,0,0,9,1,0,0,1,1,0,1,836,0,8,844,0
160,388,375,2,1,0,0,25,0,0,0,0,0,2,0,793,0,16,809,0
161,434,233,3,1,0,0,13,0,1,1,0,0,4,0,690,0,9,699,0
162,229,116,4,1,0,0,11,0,0,0,0,0,1,1,363,0,6,369,0
163,191,478,0,1,0,1,12,0,0,0,0,1,0,0,684,0,12,696,0
164,98,472,3,0,0,0,6,1,1,0,0,0,1,0,582,0,5,587,0
165,197,440,10,0,0,0,21,0,0,0,0,0,0,2,670,0,12,682,0
166,102,155,5,1,0,0,15,0,0,0,0,0,1,1,280,0,2,282,0
167,206,374,4,0,0,0,20,2,0,2,1,3,1,1,614,0,12,626,0
168,718,17,0,0,1,0,16,0,0,0,0,0,0,0,752,0,8,760,0
169,621,22,0,0,3,0,15,1,0,2,0,2,0,0,666,0,4,670,0
170,482,21,0,2,0,0,4,0,0,1,0,0,0,0,510,0,0,510,0
171,670,37,0,0,0,1,19,0,0,1,0,0,2,1,731,0,5,736,0
172,550,15,0,0,0,0,19,0,0,0,0,1,0,0,585,0,4,589,0
173,746,26,1,1,1,0,10,1,1,0,1,2,0,4,794,0,12,806,0
174,690,22,2,0,1,1,14,1,0,0,2,2,0,0,735,0,3,738,0
175,569,22,1,0,1,1,8,0,0,0,1,0,0,1,604,0,9,613,0
176,441,30,2,1,0,0,5,1,0,0,0,0,1,1,482,0,1,483,0
177,352,418,6,0,0,0,9,0,0,0,0,0,1,2,788,0,10,798,0
178,395,419,6,0,2,1,6,1,1,0,0,0,0,1,832,0,9,841,0
179,97,563,1,1,0,0,1,0,0,0,0,0,1,0,664,0,9,673,0
180,461,323,3,0,1,0,7,0,0,0,0,0,0,1,796,0,4,800,0
181,85,594,5,1,0,1,9,0,0,0,2,0,2,2,701,0,9,710,0
182,400,178,6,0,0,0,3,0,0,0,1,0,1,2,591,0,7,598,0
183,456,250,1,0,1,2,17,0,0,1,0,0,1,0,729,0,4,733,0
184,90,642,4,1,0,1,1,0,0,0,0,0,0,1,740,0,1,741,0
