polling station,Giri  Ramchandra  Vaijnath,Chauhan  Prabhatsinh  Pratapsinh,Ramsinh  Parmar,Piyushkumar  Dilipbhai  Parmar ,Shaikh  Kalim  Abdul  Latif,Shaikh  Majitmiya  Jivamiya,Gora  Shoeb  Mohmadh anif,S.N.  Chavada  (Chavada  Vakil),Chavada  Harishchandr asinh  Prabhatsinh,Patel  Pankajbhai  Ravjibhai,Mansuri  Mukhatyar  Mohammad   (Panter  M.Lala),Vankar  Manilal  Bhanabhai,Total of  Valid  Votes ,No of  rejected  Votes ,Votes for  'NOTA'  Option,Total  Votes,No of  tender  Votes 
1,7,140,95,2,1,3,0,1,3,10,10,8,280,0,13,293,0
2,5,120,157,0,0,2,2,7,1,8,2,5,309,0,12,321,0
3,15,238,78,6,1,1,1,1,1,6,16,12,376,0,45,421,0
4,12,239,76,3,1,4,2,2,0,5,3,1,348,0,7,355,0
5,14,247,168,1,4,0,0,1,1,0,3,3,442,0,1,443,0
6,4,235,100,4,2,0,0,2,2,5,9,6,369,0,10,379,0
7,2,152,75,1,0,1,0,1,4,3,8,5,252,0,4,256,0
8,8,194,42,2,0,1,0,1,2,2,5,3,260,0,9,269,0
9,4,174,49,1,1,0,0,2,1,6,4,7,249,0,4,253,0
10,15,300,147,10,2,3,0,3,1,9,4,6,500,0,6,506,0
11,11,282,66,1,0,0,0,0,1,10,3,2,376,0,4,380,0
12,3,232,88,2,2,1,1,1,3,91,8,4,436,0,21,457,0
13,5,318,60,4,2,1,0,4,3,13,9,14,433,0,24,457,0
14,5,204,27,0,2,1,0,1,1,1,7,6,255,0,8,263,0
15,7,188,279,6,1,4,1,2,2,36,10,4,540,0,24,564,0
16,8,181,91,1,0,1,1,5,4,19,5,3,319,0,10,329,0
17,6,264,33,0,0,0,0,1,2,4,2,1,313,0,3,316,0
18,6,104,28,3,2,0,1,2,1,26,3,3,179,0,5,184,0
19,3,276,339,5,1,1,0,2,1,80,1,4,713,0,14,727,0
20,12,325,49,1,0,0,1,1,3,49,13,9,463,0,13,476,0
21,2,148,80,2,1,0,1,2,1,19,3,5,264,0,6,270,0
22,2,279,102,4,1,1,0,0,1,15,9,6,420,0,19,439,0
23,4,151,33,2,2,1,0,3,0,15,1,6,218,0,13,231,0
24,7,234,197,5,2,1,0,0,4,6,5,6,467,0,7,474,0
25,5,149,62,1,2,0,1,0,0,2,2,0,224,0,0,224,0
26,2,339,18,2,1,0,1,0,1,3,5,4,376,0,9,385,0
27,8,198,28,2,0,0,2,1,0,2,2,4,247,0,9,256,0
28,12,242,198,3,2,1,1,2,1,10,8,8,488,0,11,499,0
29,4,296,79,5,0,0,2,3,6,5,8,16,424,0,29,453,0
30,5,121,65,4,1,0,1,1,3,5,11,6,223,0,29,252,0
31,9,236,29,1,1,0,1,1,1,4,6,6,295,0,12,307,0
32,3,203,69,4,1,1,0,0,2,6,2,3,294,0,8,302,0
33,1,215,42,1,0,0,1,1,1,1,4,2,269,0,2,271,0
34,1,102,12,0,0,0,0,1,1,4,1,2,124,0,5,129,0
35,7,247,17,2,0,0,1,0,0,7,2,0,283,0,4,287,0
36,4,224,105,2,0,0,0,2,2,3,7,2,351,0,14,365,0
37,13,269,66,1,1,2,1,0,1,4,8,5,371,0,9,380,0
38,1,113,61,1,3,0,1,2,1,2,5,7,197,0,11,208,0
39,8,310,39,3,0,0,1,2,3,3,7,6,382,0,22,404,0
40,9,248,68,2,0,0,0,2,2,6,7,5,349,0,17,366,0
41,10,258,119,4,2,0,2,3,5,3,18,9,433,0,10,443,0
42,5,317,79,1,0,0,0,0,0,1,4,7,414,0,4,418,0
43,11,200,64,6,1,0,2,6,1,3,4,5,303,0,23,326,0
44,7,169,74,2,1,0,0,1,3,2,5,9,273,0,8,281,0
45,2,300,103,1,0,1,1,1,2,3,4,5,423,0,13,436,0
46,7,200,47,1,1,1,1,0,2,5,4,3,272,0,5,277,0
47,2,253,41,4,0,0,0,0,0,0,3,2,305,0,5,310,0
48,4,145,130,3,1,0,1,2,7,3,3,3,302,0,14,316,0
49,10,196,237,3,1,2,2,2,3,5,1,0,462,0,12,474,0
50,3,200,126,4,0,0,0,1,2,7,1,2,346,0,8,354,0
51,6,177,122,1,0,0,1,1,0,3,5,5,321,0,12,333,0
52,4,314,74,3,1,0,0,0,1,4,3,3,407,0,2,409,0
53,4,284,20,0,0,0,0,0,1,1,3,2,315,0,3,318,0
54,5,369,89,1,1,0,0,1,3,5,12,13,499,0,28,527,0
55,11,367,58,1,1,2,2,1,1,0,12,8,464,0,14,478,0
56,3,349,134,0,1,0,1,2,1,4,1,5,501,0,7,508,0
57,4,277,67,3,1,1,2,0,1,5,1,12,374,0,15,389,0
58,10,380,82,0,0,0,0,2,1,12,10,6,503,0,18,521,0
59,11,183,184,4,1,0,2,2,2,7,6,6,408,0,13,421,0
60,10,124,180,1,1,0,0,0,4,4,15,5,344,0,32,376,0
61,17,192,165,1,2,0,0,1,1,2,4,1,386,0,8,394,0
62,5,79,19,3,0,0,0,2,1,0,2,2,113,0,7,120,0
63,0,28,584,3,1,0,2,2,1,1,2,1,625,0,1,626,0
64,3,183,70,2,0,0,0,0,3,1,3,1,266,0,5,271,0
65,2,249,38,1,0,0,0,1,0,0,5,3,299,0,4,303,0
66,1,174,43,1,0,0,0,0,0,1,4,1,225,0,2,227,0
67,7,330,64,4,0,1,0,1,1,2,5,5,420,0,6,426,0
68,3,181,68,3,0,0,0,0,3,5,4,9,276,0,2,278,0
69,7,306,76,3,1,0,0,1,0,1,1,1,397,0,4,401,0
70,2,272,74,2,1,3,2,1,3,0,2,2,364,0,2,366,0
71,3,117,164,6,0,1,0,3,1,2,9,3,309,0,4,313,0
72,6,181,58,3,1,0,1,0,1,4,9,8,272,0,11,283,0
73,4,96,12,2,0,0,0,0,0,1,1,1,117,0,5,122,0
74,3,177,33,0,0,0,0,0,0,0,3,1,217,0,2,219,0
75,2,210,26,1,0,1,0,1,0,0,3,1,245,0,3,248,0
76,2,121,121,0,0,0,0,2,1,1,4,5,257,0,2,259,0
77,3,212,175,1,0,0,0,0,3,2,2,6,404,0,7,411,0
78,6,185,89,1,0,0,1,0,2,3,7,5,299,0,6,305,0
79,0,86,18,1,1,0,0,0,0,0,0,4,110,0,0,110,0
80,1,167,87,1,0,0,0,1,1,3,0,4,265,0,5,270,0
81,2,212,91,1,0,0,0,1,4,0,2,3,316,0,4,320,0
82,3,237,44,2,1,0,2,0,0,1,2,4,296,0,4,300,0
83,3,206,198,2,1,0,0,0,2,4,6,3,425,0,8,433,0
84,0,223,155,3,1,0,0,4,1,2,8,5,402,0,8,410,0
85,5,202,90,1,1,0,0,2,2,5,2,2,312,0,12,324,0
86,16,476,147,3,3,3,2,5,4,4,12,7,682,0,15,697,0
87,4,233,31,5,1,0,2,1,1,5,3,3,289,0,3,292,0
88,7,286,82,6,3,0,1,2,2,0,5,3,397,0,8,405,0
89,8,170,160,8,1,0,2,1,0,1,3,1,355,0,6,361,0
90,8,296,97,8,0,1,2,1,1,2,4,1,421,0,14,435,0
91,5,237,86,2,1,0,2,1,1,3,3,2,343,0,8,351,0
92,8,189,64,0,0,2,0,2,1,1,6,3,276,0,9,285,0
93,3,250,159,7,3,2,0,3,3,1,9,3,443,0,7,450,0
94,4,346,138,2,2,2,0,2,1,3,2,12,514,0,15,529,0
95,3,125,33,0,0,0,1,0,2,3,0,2,169,0,11,180,0
96,4,166,36,2,1,1,0,0,2,0,8,6,226,0,7,233,0
97,5,210,52,1,0,1,0,1,2,1,4,3,280,0,6,286,0
98,1,192,148,4,0,1,0,0,0,1,5,3,355,0,7,362,0
99,15,151,157,5,0,0,0,0,1,2,0,4,335,0,5,340,0
100,0,115,81,1,0,0,0,0,0,1,3,1,202,0,1,203,0
101,8,426,149,3,3,1,2,4,4,6,19,15,640,0,30,670,0
102,2,190,170,4,1,0,0,0,0,0,6,2,375,0,9,384,0
103,2,234,121,1,0,0,0,1,0,2,4,5,370,0,2,372,0
104,6,258,127,1,0,0,2,0,2,7,5,2,410,0,6,416,0
105,6,167,128,4,1,0,1,4,1,5,4,3,324,0,14,338,0
106,3,103,220,7,0,1,1,0,1,1,3,2,342,0,6,348,0
107,0,86,141,7,0,0,0,0,0,3,3,2,242,0,9,251,0
108,2,113,97,4,0,0,1,1,0,0,3,3,224,0,5,229,0
109,2,201,84,2,1,1,1,0,2,2,1,10,307,0,12,319,0
110,5,195,161,2,0,0,1,1,4,0,4,3,376,0,11,387,0
111,10,120,224,3,1,1,0,2,4,5,2,2,374,0,6,380,0
112,12,414,266,4,2,1,0,4,2,4,9,6,724,0,10,734,0
113,8,436,89,3,3,2,2,0,3,2,9,2,559,0,10,569,0
114,4,186,116,3,0,0,0,0,5,1,3,6,324,0,6,330,0
115,3,182,86,1,0,0,0,0,1,2,3,2,280,0,5,285,0
116,3,190,57,2,1,0,0,1,0,1,2,0,257,0,3,260,0
117,2,68,110,4,0,0,1,0,1,1,3,4,194,0,3,197,0
118,5,140,238,3,1,0,0,0,1,1,4,4,397,0,4,401,0
119,2,409,68,1,0,0,0,0,0,1,1,1,483,0,4,487,0
120,17,352,254,7,1,3,1,0,1,1,4,2,643,0,13,656,0
121,4,168,156,3,0,0,0,0,1,2,5,3,342,0,4,346,0
122,2,114,134,4,0,0,0,1,3,1,4,2,265,0,6,271,0
123,4,357,155,4,1,0,2,0,3,1,5,3,535,0,4,539,0
124,3,153,166,3,1,1,3,2,3,4,3,3,345,0,11,356,0
125,8,233,317,4,0,2,2,1,2,1,9,5,584,0,17,601,0
126,11,257,185,5,2,1,1,2,2,8,9,8,491,0,21,512,0
127,0,170,121,4,1,0,1,2,1,3,6,7,316,0,9,325,0
128,4,407,141,1,0,0,1,2,0,1,4,4,565,0,7,572,0
129,1,196,99,3,1,0,1,5,0,3,5,3,317,0,5,322,0
130,0,106,40,0,0,0,0,0,0,1,0,0,147,0,2,149,0
131,4,206,200,7,1,0,1,4,6,6,13,8,456,0,11,467,0
132,5,219,163,5,0,0,0,0,2,3,4,1,402,0,8,410,0
133,2,170,56,1,0,0,2,1,0,12,8,4,256,0,10,266,0
134,6,220,141,1,1,0,0,4,4,2,5,6,390,0,5,395,0
135,2,164,130,11,0,1,2,1,4,1,1,6,323,0,6,329,0
136,2,326,163,1,0,0,0,2,2,3,7,3,509,0,13,522,0
137,5,214,247,3,0,1,0,3,2,5,6,4,490,0,12,502,0
138,3,202,140,3,2,1,1,4,2,2,0,5,365,0,6,371,0
139,2,89,110,0,0,1,0,2,3,1,2,7,217,0,3,220,0
140,2,241,105,1,0,0,1,2,0,4,7,2,365,0,5,370,0
141,3,196,127,3,0,1,0,1,1,2,1,5,340,0,1,341,0
142,17,268,302,5,2,2,1,1,4,3,7,6,618,0,12,630,0
143,6,109,86,4,0,0,1,0,5,1,7,10,229,0,14,243,0
144,3,129,141,4,0,1,0,4,2,1,4,4,293,0,6,299,0
145,2,253,56,1,0,0,1,0,0,2,0,1,316,0,4,320,0
146,0,106,155,2,4,1,2,0,0,2,2,4,278,0,3,281,0
147,0,75,104,1,1,1,0,0,0,3,4,0,189,0,3,192,0
148,4,246,220,1,1,0,1,2,0,2,11,5,493,0,8,501,0
149,5,226,101,3,3,1,0,1,1,0,6,4,351,0,6,357,0
150,4,222,296,3,2,0,0,1,4,3,4,7,546,0,7,553,0
151,10,252,206,7,0,4,2,1,3,5,0,8,498,0,21,519,0
152,4,177,274,3,0,0,1,1,1,4,4,7,476,0,5,481,0
153,8,241,201,5,2,1,1,0,2,3,3,4,471,0,7,478,0
154,3,105,83,1,0,1,1,0,2,2,6,4,208,0,8,216,0
155,2,328,149,4,0,0,1,1,4,3,3,5,500,0,8,508,0
156,8,104,303,3,0,0,2,1,9,6,7,5,448,0,25,473,0
157,4,160,240,4,2,0,1,1,4,3,2,2,423,0,12,435,0
158,3,378,113,2,0,0,0,3,0,5,7,5,516,0,14,530,0
159,4,304,148,4,2,1,0,1,2,4,1,9,480,0,12,492,0
160,4,321,97,3,2,0,1,2,2,2,11,5,450,0,15,465,0
161,12,155,376,3,1,1,0,0,4,8,16,3,579,0,9,588,0
162,9,168,213,5,0,0,1,3,1,2,7,7,416,0,11,427,0
163,3,122,186,2,1,0,2,2,2,3,8,4,335,0,11,346,0
164,3,199,255,4,0,0,1,4,3,5,6,8,488,0,19,507,0
165,5,64,428,4,0,0,2,0,0,0,3,0,506,0,4,510,0
166,3,296,127,2,0,0,0,0,1,2,1,0,432,0,9,441,0
167,7,84,506,5,0,1,1,0,1,1,3,1,610,0,5,615,0
168,5,154,43,1,0,0,0,0,0,0,4,3,210,0,8,218,0
169,4,562,190,4,3,1,0,0,1,2,2,11,780,0,8,788,0
170,6,126,677,7,3,0,0,0,0,1,1,2,823,0,11,834,0
171,4,11,541,2,0,0,0,0,1,0,4,4,567,0,2,569,0
172,6,23,716,4,1,0,1,1,3,1,8,3,767,0,8,775,0
173,6,14,432,6,1,1,0,0,2,4,1,0,467,0,5,472,0
174,1,51,243,1,0,0,0,0,1,0,2,0,299,0,4,303,0
175,1,62,214,3,1,0,0,0,0,0,0,0,281,0,7,288,0
176,1,37,406,4,0,0,0,0,0,0,1,0,449,0,3,452,0
177,2,138,220,4,0,1,0,0,1,1,0,0,367,0,4,371,0
178,4,298,149,1,0,0,1,0,0,1,0,3,457,0,4,461,0
179,2,501,92,1,0,0,0,0,0,0,1,0,597,0,8,605,0
180,6,465,106,7,1,0,0,0,0,0,0,2,587,0,5,592,0
181,4,511,145,3,0,0,1,1,2,1,3,4,675,0,10,685,0
182,5,471,35,2,0,0,0,0,0,1,0,0,514,0,6,520,0
183,6,658,79,2,0,0,1,0,0,2,1,3,752,0,9,761,0
184,4,438,59,2,0,0,0,0,1,0,0,2,506,0,4,510,0
185,1,330,103,2,0,0,0,1,0,0,3,2,442,0,5,447,0
186,0,335,105,8,1,0,1,0,1,0,0,4,455,0,8,463,0
187,9,467,292,18,1,0,0,1,4,1,7,5,805,0,26,831,0
188,60,502,237,7,6,2,3,2,1,2,11,6,839,0,23,862,0
189,3,387,143,4,2,0,0,0,0,0,4,2,545,0,4,549,0
190,3,8,1032,5,0,2,2,0,1,1,7,2,1063,0,2,1065,0
191,0,24,608,2,1,0,1,1,0,0,1,0,638,0,3,641,0
192,4,227,117,4,0,0,0,1,1,1,1,0,356,0,6,362,0
193,2,350,76,2,0,0,0,0,0,1,1,2,434,0,4,438,0
194,4,320,102,5,0,1,0,0,0,0,0,0,432,0,5,437,0
195,1,95,35,1,0,0,0,0,0,0,1,1,134,0,5,139,0
196,6,176,205,5,4,0,2,1,3,4,4,7,417,0,13,430,0
197,2,107,104,0,1,0,1,0,0,2,1,1,219,0,8,227,0
198,4,328,235,9,3,2,1,4,4,11,10,10,621,0,31,652,0
199,7,221,147,2,1,0,1,1,3,3,8,2,396,0,5,401,0
200,1,91,122,3,1,0,0,0,2,2,2,2,226,0,1,227,0
201,8,267,187,1,1,0,2,2,3,6,7,6,490,0,12,502,0
202,4,200,205,7,0,0,0,2,5,5,5,5,438,0,8,446,0
203,6,199,137,1,0,0,0,1,2,1,7,0,354,0,2,356,0
204,7,261,106,2,0,1,0,4,0,2,1,3,387,0,10,397,0
205,4,249,209,2,1,0,0,1,1,2,6,3,478,0,3,481,0
206,3,218,167,1,0,1,0,1,4,3,1,3,402,0,1,403,0
207,2,143,95,3,1,0,1,1,1,1,2,1,251,0,7,258,0
208,0,59,508,0,0,0,0,0,0,0,0,0,567,0,0,567,0
209,2,286,132,6,1,1,1,5,8,6,8,6,462,0,6,468,0
210,1,245,49,0,0,0,0,1,0,1,2,0,299,0,1,300,0
211,10,187,203,4,3,0,1,3,2,2,4,8,427,0,16,443,0
212,5,154,139,3,0,2,0,1,7,3,7,6,327,0,11,338,0
213,3,188,172,1,0,0,0,0,2,0,0,2,368,0,2,370,0
214,5,234,77,2,1,0,1,0,0,2,3,2,327,0,4,331,0
215,3,89,205,5,2,0,2,0,1,1,7,1,316,0,12,328,0
216,3,227,96,0,1,0,0,0,2,0,1,1,331,0,0,331,0
217,1,61,229,3,1,2,2,1,2,7,3,5,317,0,9,326,0
218,5,203,121,5,1,1,1,4,3,5,9,7,365,0,8,373,0
219,3,173,235,0,0,1,0,1,1,0,0,0,414,0,2,416,0
220,7,90,469,4,3,1,0,1,2,1,0,1,579,0,2,581,0
221,10,274,244,4,0,0,4,1,2,3,11,4,557,0,11,568,0
222,4,156,130,4,0,0,0,0,2,1,3,3,303,0,6,309,0
223,2,148,98,2,1,0,0,0,4,1,2,3,261,0,9,270,0
224,3,149,145,1,2,0,2,1,0,1,4,0,308,0,6,314,0
225,3,234,172,7,2,0,0,0,3,2,5,2,430,0,8,438,0
226,0,181,124,5,0,0,0,1,3,2,6,5,327,0,8,335,0
227,5,67,278,8,1,1,1,3,2,1,4,4,375,0,5,380,0
228,4,49,464,3,1,0,0,0,0,1,3,4,529,0,4,533,0
229,15,148,248,4,1,0,1,3,2,4,6,5,437,0,19,456,0
230,1,169,36,0,0,0,0,2,0,2,0,2,212,0,0,212,0
231,4,80,300,3,1,1,0,0,2,3,3,3,400,0,7,407,0
232,5,82,459,4,0,0,0,2,1,3,9,2,567,0,4,571,0
233,10,62,234,2,1,0,1,0,2,5,7,2,326,0,6,332,0
234,6,137,67,1,0,0,0,1,1,1,4,5,223,0,4,227,0
235,0,166,206,6,1,1,2,1,1,2,7,7,400,0,8,408,0
236,2,136,90,1,0,0,1,1,2,3,5,5,246,0,9,255,0
237,1,229,50,1,0,0,0,0,1,2,3,3,290,0,2,292,0
238,9,184,81,4,0,0,0,0,2,0,5,3,288,0,4,292,0
239,1,394,113,3,0,0,0,0,0,1,2,2,516,0,0,516,0
240,1,116,321,3,0,0,1,2,2,1,0,3,450,0,4,454,0
241,2,302,127,1,0,1,0,0,0,0,3,1,437,0,1,438,0
242,6,169,226,2,0,0,0,0,2,2,10,2,419,0,11,430,0
243,3,191,121,1,0,0,0,1,3,3,10,7,340,0,14,354,0
244,5,135,63,0,1,1,0,1,1,2,2,2,213,0,4,217,0
245,2,86,65,0,1,1,0,0,0,4,4,1,164,0,6,170,0
246,1,164,243,1,1,1,0,1,0,5,2,5,424,0,8,432,0
247,4,206,192,3,2,0,0,0,1,3,7,4,422,0,7,429,0
248,4,129,150,0,2,0,0,2,3,1,2,5,298,0,10,308,0
249,1,167,230,8,0,0,0,0,1,3,3,7,420,0,6,426,0
250,3,113,176,1,1,0,0,0,0,0,2,1,297,0,8,305,0
251,0,137,84,1,2,1,0,0,0,2,1,3,231,0,6,237,0
252,3,194,88,0,2,1,2,0,1,5,4,4,304,0,13,317,0
253,9,144,369,2,4,0,2,1,4,5,5,6,551,0,6,557,0
254,8,203,219,5,3,1,3,2,4,5,14,5,472,0,15,487,0
255,2,207,89,0,0,0,0,0,1,0,1,0,300,0,0,300,0
256,14,126,101,0,1,0,2,1,3,2,5,6,261,0,10,271,0
257,5,194,121,4,0,0,1,0,3,0,4,3,335,0,1,336,0
258,4,148,65,0,1,0,2,2,1,1,2,4,230,0,5,235,0
259,2,215,101,1,0,0,1,2,1,2,2,0,327,0,3,330,0
260,6,264,155,5,1,2,1,3,1,6,2,5,451,0,6,457,0
261,0,79,44,0,1,1,0,0,0,2,0,0,127,0,1,128,0
262,8,231,86,3,1,0,1,0,1,4,2,3,340,0,6,346,0
263,8,245,161,5,1,2,1,0,0,0,0,6,429,0,7,436,0
264,9,322,163,3,2,0,1,0,0,2,5,9,516,0,14,530,0
265,15,168,109,2,0,1,1,0,1,2,3,3,305,0,16,321,0
266,8,204,62,4,4,0,0,2,1,2,4,6,297,0,4,301,0
267,7,201,78,4,1,0,2,1,2,2,6,5,309,0,8,317,0
268,7,179,60,3,0,0,0,1,1,1,0,0,252,0,4,256,0
269,11,401,174,8,0,1,2,3,3,5,5,8,621,0,19,640,0
270,8,290,61,3,3,1,0,1,3,5,11,16,402,0,19,421,0
271,7,224,69,1,0,1,2,1,2,2,5,4,318,0,8,326,0
272,8,279,98,5,2,0,1,2,2,2,6,6,411,0,14,425,0
273,7,351,97,3,2,0,1,0,2,1,0,5,469,0,10,479,0
274,5,274,145,4,2,0,0,2,0,1,2,3,438,0,8,446,0
275,7,138,94,2,2,1,0,2,1,0,2,1,250,0,5,255,0
276,5,246,171,0,1,1,1,0,2,1,7,5,440,0,12,452,0
277,13,439,47,1,1,0,0,0,0,5,11,15,532,0,14,546,0
278,10,173,209,3,0,0,0,1,2,1,5,5,409,0,17,426,0
279,8,239,208,5,1,2,1,1,3,3,4,1,476,0,19,495,0
280,9,368,237,12,1,3,1,0,2,3,10,16,662,0,21,683,0
281,12,390,294,8,2,2,2,2,5,4,9,6,736,0,30,766,0
282,16,249,162,2,1,2,1,2,4,2,14,20,475,0,37,512,0
283,5,186,176,3,0,0,0,0,5,1,3,4,383,0,9,392,0
284,5,316,174,0,0,1,1,1,2,2,4,3,509,0,13,522,0
285,0,196,131,1,0,0,2,1,2,1,0,5,339,0,7,346,0
286,5,228,93,4,0,1,0,1,3,1,10,6,352,0,19,371,0
287,16,449,168,5,2,0,0,1,2,5,11,8,667,0,11,678,0
288,8,49,213,4,1,0,0,1,1,1,5,8,291,0,14,305,0
289,9,377,92,1,1,2,1,4,2,7,8,16,520,0,24,544,0
290,5,314,157,4,1,0,0,0,1,1,8,4,495,0,15,510,0
291,5,170,157,2,0,0,0,1,2,1,2,1,341,0,5,346,0
292,2,123,159,3,1,0,0,0,1,0,0,2,291,0,2,293,0
293,9,265,108,3,1,0,1,1,1,2,9,6,406,0,18,424,0
294,3,33,172,3,2,0,0,0,1,6,3,9,232,0,10,242,0
295,8,200,176,2,1,0,0,0,3,3,0,1,394,0,5,399,0
296,13,375,94,3,2,0,1,1,4,4,7,5,509,0,13,522,0
297,7,117,262,7,2,1,2,0,2,6,12,10,428,0,29,457,0
298,11,104,169,2,0,0,2,0,4,5,10,14,321,0,16,337,0
299,7,170,127,0,1,0,1,0,2,4,11,5,328,0,12,340,0
300,7,318,235,3,1,0,2,0,2,3,4,3,578,0,9,587,0
301,6,181,110,0,0,1,1,0,2,2,6,6,315,0,14,329,0
302,3,109,101,3,0,0,0,0,0,0,1,0,217,0,4,221,0
303,5,85,34,2,1,0,0,0,3,3,3,7,143,0,3,146,0
304,4,267,78,4,1,3,1,0,2,2,1,3,366,0,7,373,0
305,3,49,148,3,2,0,0,2,1,2,7,0,217,0,5,222,0
306,13,258,82,2,1,1,0,1,1,6,7,0,372,0,16,388,0
307,17,457,153,7,1,2,1,2,5,5,25,18,693,0,36,729,0
308,26,270,172,5,3,0,0,2,2,7,5,13,505,0,16,521,0
309,4,362,126,1,0,0,0,1,1,3,10,11,519,0,15,534,0
310,11,208,186,6,1,0,3,1,3,5,8,1,433,0,21,454,0
311,0,391,123,2,0,0,0,0,1,2,5,2,526,0,0,526,0
312,9,450,159,2,0,0,0,0,2,1,1,1,625,0,5,630,0
313,4,343,224,7,0,2,0,1,3,3,4,1,592,0,12,604,0
314,4,208,363,8,0,2,1,2,1,1,5,3,598,0,11,609,0
315,2,213,358,6,0,0,1,0,2,1,4,0,587,0,5,592,0
316,11,386,154,4,3,1,2,0,1,2,13,14,591,0,33,624,0
317,2,145,61,1,0,0,0,0,1,0,4,5,219,0,9,228,0
318,10,275,124,1,2,3,0,0,1,2,8,6,432,0,5,437,0
319,31,389,226,7,6,3,0,4,3,5,7,12,693,0,28,721,0
320,11,279,138,11,2,1,4,2,7,4,23,13,495,0,20,515,0
321,7,449,152,2,0,0,0,2,1,3,4,3,623,0,5,628,0
322,9,149,109,1,0,0,2,2,1,1,7,5,286,0,22,308,0
323,8,421,47,3,0,0,0,0,0,1,6,8,494,0,18,512,0
